[
  {
    "map": [
      [0, 0, 3, 3, 0, 0, 3, 3, 0, 0, 0, 0, 0, 0, 3, 3, 0, 0, 3, 3, 0, 0, 3, 3, 0, 0],
      [0, 0, 3, 3, 0, 0, 3, 3, 0, 0, 0, 0, 0, 0, 3, 3, 0, 0, 3, 3, 0, 0, 3, 3, 0, 0],
      [0, 0, 3, 3, 0, 0, 3, 3, 0, 0, 3, 3, 0, 0, 3, 3, 0, 0, 3, 3, 0, 0, 3, 3, 0, 0],
      [0, 0, 3, 3, 0, 0, 3, 3, 0, 0, 3, 3, 0, 0, 3, 3, 0, 0, 3, 3, 0, 0, 3, 3, 0, 0],
      [0, 0, 4, 4, 0, 0, 4, 4, 0, 0, 4, 4, 0, 0, 0, 0, 0, 0, 4, 4, 0, 0, 4, 4, 0, 0],
      [0, 0, 3, 3, 0, 0, 3, 3, 0, 0, 3, 3, 0, 0, 0, 0, 0, 0, 3, 3, 0, 0, 0, 0, 0, 0],
      [0, 0, 4, 4, 0, 0, 4, 4, 0, 0, 4, 4, 0, 0, 4, 4, 0, 0, 4, 4, 0, 0, 0, 0, 0, 0],
      [0, 0, 3, 3, 0, 0, 0, 0, 0, 0, 3, 3, 0, 0, 3, 3, 0, 0, 3, 3, 0, 0, 3, 3, 0, 0],
      [0, 0, 4, 4, 0, 0, 0, 0, 0, 0, 4, 4, 0, 0, 4, 4, 0, 0, 0, 0, 0, 0, 4, 4, 0, 0],
      [0, 0, 0, 0, 0, 0, 3, 3, 0, 0, 3, 3, 0, 0, 3, 3, 0, 0, 0, 0, 0, 0, 3, 3, 0, 0],
      [0, 0, 0, 0, 0, 0, 4, 4, 0, 0, 4, 4, 0, 0, 4, 4, 0, 0, 4, 4, 0, 0, 4, 4, 0, 0],
      [0, 0, 3, 3, 0, 0, 3, 3, 0, 0, 3, 3, 0, 0, 3, 3, 0, 0, 3, 3, 0, 0, 3, 3, 0, 0],
      [0, 0, 4, 4, 0, 0, 4, 4, 0, 0, 4, 4, 0, 0, 4, 4, 0, 0, 4, 4, 0, 0, 4, 4, 0, 0],
      [0, 0, 0, 0, 0, 0, 0, 3, 0, 0, 0, 0, 0, 0, 3, 3, 0, 0, 3, 3, 0, 0, 3, 3, 0, 0],
      [0, 0, 0, 0, 0, 0, 0, 0, 0, 0, 0, 0, 1, 1, 4, 4, 0, 0, 4, 4, 0, 0, 4, 4, 0, 0],
      [0, 0, 3, 3, 0, 0, 0, 0, 0, 0, 3, 3, 1, 1, 3, 3, 0, 0, 3, 3, 0, 0, 3, 3, 0, 0],
      [0, 0, 4, 4, 0, 0, 0, 4, 0, 0, 4, 4, 2, 2, 4, 4, 0, 0, 4, 4, 0, 0, 4, 4, 0, 0],
      [0, 0, 3, 3, 0, 0, 3, 3, 0, 0, 3, 3, 2, 2, 3, 3, 0, 0, 3, 3, 0, 0, 3, 3, 0, 0],
      [0, 0, 4, 4, 0, 0, 4, 4, 0, 0, 4, 4, 2, 2, 4, 4, 0, 0, 0, 0, 0, 0, 0, 0, 0, 0],
      [0, 0, 4, 4, 0, 0, 4, 4, 0, 0, 4, 4, 0, 0, 0, 0, 0, 0, 0, 0, 0, 0, 0, 0, 0, 0],
      [0, 0, 4, 4, 0, 0, 4, 4, 0, 0, 4, 4, 0, 0, 0, 0, 0, 0, 4, 4, 0, 0, 4, 4, 0, 0],
      [0, 0, 4, 4, 0, 0, 4, 4, 0, 0, 4, 4, 0, 0, 4, 4, 0, 0, 4, 4, 0, 0, 4, 4, 0, 0],
      [0, 0, 4, 4, 0, 0, 4, 4, 0, 0, 4, 4, 0, 0, 0, 0, 0, 0, 4, 4, 0, 0, 4, 4, 0, 0],
      [0, 0, 4, 4, 0, 0, 4, 4, 0, 0, 0, 0, 0, 0, 0, 0, 0, 0, 4, 4, 0, 0, 4, 4, 0, 0],
      [0, 0, 4, 4, 0, 0, 4, 4, 0, 0, 0, 0, 0, 0, 4, 4, 0, 0, 4, 4, 0, 0, 4, 4, 0, 0]
    ],
    "user": {
      "col": 12,
      "row": 23,
      "direction": "up"
    },
    "enemy": {
      "positions": [
        {
          "col": 0,
          "row": 0,
          "direction": "down"
        },
        {
          "col": 12,
          "row": 0,
          "direction": "down"
        },
        {
          "col": 24,
          "row": 0,
          "direction": "down"
        }
      ],
      "total": 20,
      "max": 3
    }
  }
]